######################################################
##...............Z..................................##
##..................................................##
##..................................................##
##..###.....###.....................................##
##..#.#.....#.#...,.................................##
##..###.....###.....................................##
##..................................................##
####................................................##
##..................................................##
##..................................................##
##..................................................##
##..................................................##
##..................................................##
##..................................................##
##..................................................##
##..................................................##
######.....###.................P.....##################
####.....#.#...,....................................##
##.....###.......................###................##
######################################################
